R 1000 600
C 77,162,201

NO ./textures/eagle.xpm
SO ./textures/greystone.xpm
EA ./textures/red.xpm
WE ./textures/purplestone.xpm

S ./textures/tonneau.xpm
F  100 , 50 , 0





        1111111111111111111111111
        1000000000110000000000001
        1011000001110000002000001
        1001000000000000000000001
111111111011000001110000000000001
100000000011000001110111111111111
11110111111111011100020010001
11110111111111011101000010001
110000001101010111000S0010001
10002000000000000000000000001
10000000000000001101000010001
1100000111010101111100000000111
11110111 1110101 101002000001
11111111 1111111 111111111111
