R 1000 600
C 000, 1, 100

NO ./textures/eagle.xpm
SO ./textures/wood.xpm
EA ./textures/mossy.xpm
WE ./textures/brickstone.xpm

S ./textures/coin.xpm
F  255, 255, 000





1111111111111111111
10000000000000001
10000000000000001
10020002000020001
10000000000000001
100000N0000020001
10000000000000001
10200002000000001
10000000000020001
1111111111111111111
