11111441111
10000000001
11110800001
10000100001
1111111111A
